../assets/sheet.bmp
16
-1 -1 -1 30 -1 -1 -1 -1 -1 -1 -1 -1 -1 -1 -1 30 -1 -1 -1 -1 
-1 -1 -1 30 -1 -1 -1 -1 -1 -1 -1 -1 -1 -1 -1 30 -1 -1 -1 -1 
-1 -1 -1 30 -1 -1 -1 -1 -1 -1 -1 -1 -1 -1 -1 30 -1 -1 10 11 
-1 -1 -1 30 -1 -1 -1 -1 -1 -1 -1 -1 -1 -1 -1 30 -1 -1 -1 -1 
-1 -1 -1 30 -1 -1 -1 -1 13 -1 -1 -1 -1 -1 -1 30 -1 -1 -1 -1 
-1 -1 -1 30 -1 -1 -1 -1 30 -1 -1 -1 10 11 11 29 -1 -1 -1 -1 
-1 -1 -1 30 -1 -1 -1 -1 30 -1 -1 -1 -1 -1 -1 27 11 11 -1 -1 
-1 -1 -1 -1 -1 -1 -1 -1 30 -1 -1 -1 -1 -1 -1 30 -1 -1 -1 -1 
-1 -1 -1 -1 -1 -1 -1 -1 27 11 11 -1 -1 -1 -1 -1 -1 -1 -1 -1 
11 11 -1 -1 -1 -1 -1 -1 30 -1 -1 -1 -1 -1 -1 -1 -1 -1 -1 -1 
-1 -1 -1 -1 -1 -1 -1 -1 30 -1 -1 -1 -1 -1 -1 -1 -1 -1 -1 -1 
11 11 11 11 11 11 11 11 11 11 11 11 11 11 11 11 11 11 11 11 
